8 8 8 8 8 8 8 8 8 8 8 4 4 6 4 4 6 4 6 4 4 4 6 4 1
8 0 0 0 0 0 0 0 0 0 8 4 0 0 0 0 0 0 0 0 0 0 0 4 1 
8 0 9 3 0 0 0 0 0 8 8 4 0 0 0 0 0 0 0 0 0 0 0 6 1
8 0 0 3 0 0 0 0 0 0 0 0 0 0 0 0 0 0 0 0 0 0 0 6 1
8 0 3 3 0 0 0 0 0 8 8 4 0 0 0 0 0 0 0 0 0 0 0 4 1
8 0 0 0 0 0 0 0 0 0 8 4 0 0 0 0 0 6 6 6 0 6 4 6 1
8 8 8 8 0 8 8 8 8 8 8 4 4 4 4 4 4 6 0 0 0 0 0 6 1
3 3 3 3 3 3 3 3 3 0 8 0 8 0 8 0 8 4 0 4 0 6 0 6 1
3 7 0 0 0 0 0 0 3 8 0 8 0 8 0 8 8 6 0 0 0 0 0 6 1
6 0 0 0 0 0 0 0 0 0 0 0 0 0 0 0 8 6 0 0 0 0 0 4 1
6 0 0 0 0 0 0 0 0 0 0 0 0 0 0 0 8 6 0 6 0 6 0 6 1
3 7 0 0 0 0 0 0 3 8 0 8 0 8 0 8 8 6 4 6 0 6 6 6 1
3 3 3 3 0 3 3 3 3 8 8 4 0 6 8 4 8 3 3 3 0 3 3 3 1
2 2 2 2 0 2 2 2 2 4 6 4 0 0 6 0 6 3 0 0 0 0 0 3 1
2 2 0 0 0 0 0 2 2 4 0 0 0 0 0 0 4 3 0 0 0 0 0 3 1
2 0 0 0 0 0 0 0 2 4 0 0 0 0 0 0 4 3 0 0 0 0 0 3 1
1 0 0 0 0 0 0 0 1 4 4 4 4 4 6 0 6 3 3 0 0 0 3 3 1
2 0 0 0 0 0 0 0 2 2 2 1 2 2 2 6 6 0 0 5 0 5 0 5 1
2 2 0 0 0 0 0 2 2 2 0 0 0 2 2 0 5 0 5 0 0 0 5 5 1
2 0 0 0 0 0 0 0 2 0 0 0 0 0 2 5 0 5 0 5 0 5 0 5 1
1 0 0 0 9 0 0 0 0 0 0 0 0 0 0 0 0 0 0 0 0 0 0 5 1
2 0 0 0 0 0 0 0 2 0 0 0 0 0 2 5 0 5 0 5 0 5 0 5 1
2 2 0 0 0 0 0 2 2 2 0 0 0 2 2 0 5 0 5 0 0 0 5 5 1
2 2 2 2 1 2 2 2 2 2 2 1 2 2 2 5 5 5 5 5 5 5 5 5 1
